8
S 0 T 0 0 0 0 0
0 S T 0 S 0 0 0
B 0 T W 0 0 0 0
B B T 0 W 0 X 0
0 0 T 0 0 0 0 0
P 0 T 0 0 0 0 0
0 0 0 0 0 0 0 0
0 0 0 0 0 0 0 0